BBBBBBBBBBBBBBBBBBBBBBBBBBBBBB
B                            B
B          J                 B
BXXXXXXXXXXXXXXXXXXXXXXXXXXXXB
BXXXXXSXXXXXXXXXXXXXXXXXXXXXXB
BCXXXXXSXX  XXXXXXXXXXXXXXGXXB
BCXXGXXXXXXX  XXXXXXX XXXXGXXB
BXXXGXXXXXXXXX   XXX XXXXXGXXB
BXXXXGXXXXXXXXXXXX  XXXXXXGXXB
BXXXXGXXXXXXXTXXXXX  XXXXGXXXB
BXXXUUXXXXXXXTTXXXXX XXXXGXXXB
BXXXXXXXXXXXX XXXXXX XXXXGXXXB
BXXXXXXXXX XXXXXXXXX XXXXXXXXB
BXXX XX XXXXXXXCCXXXXXXXXXXXXB
B  XXXXXXXXXXXXXCCXXXXXXXXXXXB
BXXXXXXXXXXXXXXXXXXXXXXXXXXXXB
BXXUUXXXXXSSXXXXXXXXXXTTXXXXXB
BXXXXXXXXXXXSSXSSSXXXXXXTTXXXB
BXXXXXXXXXXXXXXXXXXXXXXXXXXXXB
BBBBBBBBBBBBBBBBBBBBBBBBBBBBBB
