BBBBBBBBBBBBBBBBBBBBBBBBBBBBBB
B           SS               B
B          J SS              B
BXXXXXXXXXXXXXSXXXXXXXXXXXXXXB
BXXXXXXXXXXXXXSXXXXXXXXXXXXXXB
BXXXXXXXXXX      XXXXXXXXXXXXB
BXXXXXXXXXX XXXX XXXXXXXXXXXXB
BXXXXXXXXXX XXXX XXXXXXXXXXXXB
BXXXXXXXXXX XXXX  XXXXXXXXXXXB
BXXXXXXXXXX XXXX      XXXXXXXB
BXXXXXXXXX  XXX  XXXXX  XXXXXB
BXXXXXX       X XXXXXXX XXXXXB
BXXXXXX  XXXX  XXXXXXXX XXXXXB
BXXXXXXX  XX   XXXXXXX  XXXXXB
BXXXXXXXXX   X  XXXX  XXXXXXXB
BXXXXXXXXXXXXXX     XXXXXXXXXB
BXXXXXXXXXXXXXXXXXXXXXXXXXXXXB
BXXXXXXXXXXXXXXXXXXXXXXXXXXXXB
BXXXXXXXXXXXXXXXXXXXXXXXXXXXXB
BBBBBBBBBBBBBBBBBBBBBBBBBBBBBB
