BBBBBBBBBBBBBBBBBBBBBBBBBBBBBB
BXXXGTSSSGUXXXXXXXXGSXXXXUSSGB
BXXGUXXXUGXXXXXXXXXXSGXXXXXTGB
BXCCCXXXXXXXXXXXXXXXXSXXXXXCTB
BXXCCXXXXXXXXXXXXXXXXXXXXXXXUB
BXXSXXXXXXXXX  XXXXXXXXX XXXXB
BXGSXXXXXXXCC     XXXXXX   XXB
BXSS XXXXXXC       XXXX  XXXXB
BXS  XXXXXX        UXXXXXXXXXB
BXX  XXXXXS         UXXXXXXXXB
BXX  XXXXXS    J     XXXXXXXXB
BXXXXXXXXXXXXSCXCUXXXXXXXXXXXB
BXXXXXXXXXXXXSSXXXXXXXXXXXXXXB
BXXXXXXXXXXXXXXXXXXXXXXXXXXX B
BXXXXXXXXXCSXXXXXXXXXXXSXSUX B
BXXCUXXXSSCCXXXXXXXXXXXSSGUS B
BXUTXXXXGGSXXXXXXXXXXXXUCXCG B
BXXUCXXXXUGXXXXXXXXXXXXXUXSG B
BXXXXXXXXXXSXXTXXXXXXXXCXSST B
BBBBBBBBBBBBBBBBBBBBBBBBBBBBBB
