BBBBBBBBBBBBBBBBBBBBBBBBBBBBBB
B                            B
B          J                 B
BXXXX  XXXXXXXXXX XXXXX  XXXXB
BXXXX  XXXXXXXXXX XXXXX  XXXXB
BXXXX    XXXCCXXX XXX    XXXXB
BXXXX    XXXUUUUC XX      XXXB
BXXXXXXXXXXCCXXXX XXXXXXXXXXXB
BXXXXXXXXXXXXXXXX XXXXXXXXXXXB
BXXXXXSSXXXXXXXXX XXXXXXXXXXXB
BXXXXS  XXCCXXXXXXXXX  SUXXXXB
BXXXU   XGSXXXXXXXXXX   SSXXXB
BXXXXXXXXXSSSXXXXXXXXCUUGXXXXB
BXXXXXXXXXXXXXXXXXXXXXXXXXXXXB
BXXXXXXXXXXXXXXCCXXXXXXXXXXXXB
BXXXXXXXXXXXXSGGSSCXXXXXXXXXXB
BXXXXXXXXXXXXSSSTSCXXXXXSXXXXB
BXXXXGS  XXXXXXXXUXXXXXXXXXXTB
BXXXGTS    XXXXXXXXXXXXXXXXGSB
BBBBBBBBBBBBBBBBBBBBBBBBBBBBBB
