BBBBBBBBBBBBBBBBBBBBBBBBBBBBBB
B                            B
B          J                 B
BXXXX XXXXXXXXXXXXXXXXXXXXXXXB
BXXXX XXXXXXXXXXXXXXXXXXXXXXXB
BXXXX    XXXXXXXXXXXXXXXXXXXXB
BXXSSSXXXXXXXSSSXXXXXXXXXSSXXB
BXXSSXXXXXXXXSGXXXXXXXXXXSSXXB
BXXXXXXXXXXXXXCCXXXXXXXXXXXXXB
BXXXXXXXXXXXXXXXXXXXXXXX XXXXB
BXXXXXXXXX   GXXXXXXXXXX XXXXB
BXXXXXXXXXC  GXXXXCXXXG    GXB
BXXXXGSCXXXXXXXXXXXXXXXXSXXXXB
BXXSGCUXXXXXX     XXXXXXSXXXXB
BXXXXXXXXXXXXXGG  XXXXXXSXXGXB
BXXXXXXGGXXXXXXTTGUXXXXXXXXTXB
BXGCCCXXXXXXXXXXXXXXXXXXXXXUXB
BXXXTTUXXXXXXXXXXXXXXXXCSGXXXB
BXXXXXXXXXXXXXXXXXXXXXXXTTXXXB
BBBBBBBBBBBBBBBBBBBBBBBBBBBBBB